12 24
########################
#.........#......#.....#
##.....O###............#
###..............#.....#
####.............#.....#
##################.....#
####.............#.....#
###...............O..###
##...........#########o#
#..O.O...............oo#
#S....................o#
########################

